###WWWWW###########
###W...W###########
###W.BBWWWW########
###W..B.B.W########
###W.BW...W########
WWWW..WWB.WWWWWW###
WS....WW.....GGW###
WW...........GGW###
#WWWWWWWWWW..GGW###
##########WWWWWW###
###################
###################
###################