WWWWWWWWWWW#####
WGGW.....SW#####
WGGW.B.B.WW#####
W.....B.WW######
W..W.B.WW#######
W..W..WW########
W....WW#########
################
################
################
################
################