#WWWW###########
WW..WWWW########
W...B..W########
W.BBWS.W########
W.B.WW.W########
W....WGW########
WW.B.GGW########
#WW..GGW########
##WWWWWW########
################
################
################
################