###WWWW#############
###W..W#############
WWWW.BWWWW##########
WS....B..W##########
WW....WG.W##########
#W..BWW.GWWWWW######
#WW...WG.....W######
##W..........W######
##WW....WWW..W######
###WWWWWW#WWWW######
####################
####################
####################