#######WWWW#####
#######W..W#####
WWWWWWWWB.W#####
W..B......W#####
W..WWWWWB.W#####
W.........W#####
W..WWWWW..W#####
W.....GW..W#####
W....GWW..W#####
W..WGWW...W#####
WS..ww....W#####
WW.......WW#####
#WWWWWWWWW######
